#Example: Large parts of Africa and south east Asia
tropical = { 
	21 22 23 24 25 53 67 89 91 98
	99 100 105 106 107 108 109 110 111 112
	113 114 115 116 117 118 119 120 121 122
	123 124 125 126 127 128 129 130 131 132
	133 134 135 136 137 138 139 140 141 142
	143 144 145 146 147 148 149 150 151 152
	153 154 155 156 157 158 159 160 161 162
	163 164 165 166 167 168 169 170 171 172
	173 174 175 176 177 178 179 180 181 182
	183 184 185 186 187 188 189 190 191 192
	193 194 195 196 197 198 199 200 201 202
	203 207 210 211 212 213 215 217 220 221
	225 
}
arid = { 
}
arctic = { 
	# Pornof
}
mild_winter = { 
	# Pornof
	21 22 23 24 25 53 67 89 91 98
	99 100 105 106 107 108 109 110 111 112
	113 114 115 116 117 118 119 120 121 122
	123 124 125 126 127 128 129 130 131 132
	133 134 135 136 137 138 139 140 141 142
	143 144 145 146 147 148 149 150 151 152
	153 154 155 156 157 158 159 160 161 162
	163 164 165 166 167 168 169 170 171 172
	173 174 175 176 177 178 179 180 181 182
	183 184 185 186 187 188 189 190 191 192
	193 194 195 196 197 198 199 200 201 202
	203 207 210 211 212 213 215 217 220 221
	225 
}
normal_winter = { 
}
severe_winter = { 
}
impassable = { 
	21 22 23 24 53 67 89 91 98 99
	100 207 210 211 212 213 215 217 220 221
	225 601 602 603 726 2417 2801 2802 2803 2804
	2805 2806 2807 2808 2809 
}
mild_monsoon = { 
}
normal_monsoon = { 
}
severe_monsoon = { 
}
equator_y_on_province_image = 18
